W ER1 L D 
W ER1 L D 
IH0 N S IH1 S T 
L IH1 S T 
W ER1 L D 
W ER1 L D 
AE2 F T ER0 N UW1 N 
W ER1 L D 
W ER1 L D 
W ER1 L D 
S UW1 N 
W ER1 L D 
W ER1 L D 
S P IY1 K S 
CH IY1 K S 
W ER1 L D 
W ER1 L D 
S P UW1 N 
W ER1 L D 
W ER1 L D 
W ER1 L D 
S UW1 N 
W ER1 L D 
W ER1 L D 
M IH1 S T 
CH IY1 K S 
D IH0 S M IH1 S T 
W ER1 L D 
W ER1 L D 
T UW1 N 
W ER1 L D 
W ER1 L D 
W ER1 L D 
S UW1 N 
